1111111111111111111111111111
1P0C00100100000001001C1000E1
1000001001000000000010100001
1000001001000111011111100001
1011101001000100000000100001
1000C00001000100001000100001
10111000000C0000001000000001
1000CC00000C010C0010C0100C01
1111111111111111111111111111
