11111111111111111111111111111111111111111111111111111
10000010010000000000001000000000000000000000000000001
10000010010000000000001000010111101101100111011000001
100000100000000000100010000000000C0000000C00000100001
10000000010000000010000000000000011111111000000100001
10000010010000000110001000000000000000000000000100001
100000P000000000CC0000000000000000C00000000000010E001
10000010010000000100001000000000000000000000000100001
10000010000000000000000000000000011111111000001100001
10000000010C00000000000000000000000000000000000000001
10000000000000001000000000000000000000000000000000001
10000010000001011000000000000000000CCC000000000000001
1000000000000000000000100000000C000000000000000000001
10000010010000000000001000000000000000000000000000001
11111111111111111111111111111111111111111111111111111
